138, 138, 138, 138, 138, 138, 138, 138, 138, 138, 138, 138, 138, 138, 138, 138, 138, 138, 138, 138, 138, 138, 138, 138, 138, 138, 138, 138, 138, 138, 138, 138, 138, 138, 138, 138, 138, 138, 138, 138
138, 138, 138, 138, 138, 138, 138, 138, 138, 138, 138, 138, 138, 138, 0, 0, 0, 0, 0, 0, 18, 18, 0, 0, 0, 0, 0, 0, 138, 138, 138, 138, 138, 138, 138, 138, 138, 138, 138, 138
138, 138, 138, 138, 138, 138, 138, 138, 138, 138, 138, 138, 138, 138, 0, 0, 0, 0, 0, 0, 18, 18, 0, 0, 0, 0, 0, 0, 138, 138, 138, 138, 138, 138, 138, 138, 138, 138, 138, 138
138, 138, 138, 138, 138, 138, 138, 138, 138, 138, 138, 138, 138, 138, 0, 0, 0, 0, 0, 0, 0, 0, 0, 0, 0, 0, 0, 0, 138, 138, 138, 138, 138, 138, 138, 138, 138, 138, 138, 138
138, 138, 138, 138, 138, 138, 138, 138, 138, 138, 138, 138, 138, 138, 0, 0, 0, 0, 0, 0, 0, 0, 0, 0, 0, 0, 0, 0, 138, 138, 138, 138, 138, 138, 138, 138, 138, 138, 138, 138
138, 138, 138, 138, 138, 138, 138, 138, 138, 0, 0, 0, 0, 134, 0, 0, 0, 0, 0, 0, 0, 0, 0, 0, 0, 0, 0, 0, 134, 0, 0, 0, 0, 0, 138, 138, 138, 138, 138, 138
138, 138, 138, 138, 138, 138, 138, 138, 138, 0, 0, 0, 0, 134, 0, 0, 0, 0, 0, 0, 0, 0, 0, 0, 0, 0, 0, 0, 134, 0, 0, 0, 0, 0, 138, 138, 138, 138, 138, 138
138, 138, 138, 138, 138, 138, 138, 138, 138, 0, 0, 138, 138, 138, 0, 0, 0, 0, 0, 0, 0, 0, 0, 0, 0, 0, 0, 0, 138, 138, 138, 138, 0, 0, 138, 138, 138, 138, 138, 138
138, 138, 138, 138, 138, 138, 138, 138, 138, 0, 0, 138, 138, 138, 0, 0, 0, 0, 138, 0, 0, 0, 0, 138, 0, 0, 0, 0, 138, 138, 138, 138, 0, 0, 138, 138, 138, 138, 138, 138
138, 138, 138, 138, 138, 138, 138, 138, 138, 0, 0, 138, 138, 138, 138, 0, 0, 138, 138, 138, 0, 0, 138, 138, 138, 0, 0, 138, 138, 138, 138, 138, 0, 0, 138, 138, 138, 138, 138, 138
138, 138, 138, 138, 138, 138, 138, 138, 138, 0, 0, 138, 138, 138, 138, 0, 0, 138, 138, 138, 0, 0, 138, 138, 138, 0, 0, 138, 138, 138, 138, 138, 0, 0, 138, 138, 138, 138, 138, 138
138, 138, 138, 138, 138, 138, 138, 138, 138, 0, 0, 138, 138, 138, 67, 57, 57, 67, 138, 39, 29, 29, 39, 138, 109, 99, 99, 109, 138, 138, 138, 138, 0, 0, 138, 138, 138, 138, 138, 138
138, 138, 138, 138, 138, 138, 138, 138, 138, 0, 0, 138, 138, 138, 138, 0, 138, 138, 138, 138, 0, 138, 138, 138, 138, 0, 138, 138, 138, 138, 138, 138, 0, 0, 138, 138, 138, 138, 138, 138
138, 138, 138, 138, 138, 138, 138, 138, 138, 0, 0, 138, 138, 138, 138, 0, 138, 138, 138, 138, 0, 138, 138, 138, 138, 0, 138, 138, 138, 138, 138, 138, 0, 0, 138, 138, 138, 138, 138, 138
138, 138, 138, 138, 138, 138, 138, 138, 138, 0, 0, 138, 138, 138, 138, 59, 138, 138, 138, 138, 31, 138, 138, 138, 138, 101, 138, 138, 138, 138, 138, 138, 0, 0, 138, 138, 138, 138, 138, 138
138, 138, 138, 138, 138, 138, 138, 138, 138, 0, 0, 138, 138, 138, 138, 138, 138, 138, 138, 138, 138, 138, 138, 138, 138, 138, 138, 138, 138, 138, 138, 138, 0, 0, 138, 138, 138, 138, 138, 138
138, 138, 138, 138, 138, 138, 138, 138, 138, 0, 0, 138, 138, 138, 138, 138, 138, 138, 138, 138, 138, 138, 138, 138, 138, 138, 138, 138, 138, 138, 138, 138, 0, 0, 138, 138, 138, 138, 138, 138
138, 138, 138, 138, 138, 138, 138, 138, 138, 0, 0, 0, 0, 0, 0, 0, 0, 0, 0, 0, 0, 0, 0, 0, 0, 0, 0, 0, 0, 0, 0, 0, 0, 0, 138, 138, 138, 138, 138, 138
138, 138, 138, 138, 138, 138, 138, 138, 138, 0, 0, 0, 0, 0, 0, 0, 0, 0, 0, 0, 0, 0, 0, 0, 0, 0, 0, 0, 0, 0, 0, 0, 0, 0, 138, 138, 138, 138, 138, 138
138, 138, 138, 138, 138, 138, 138, 138, 138, 138, 138, 138, 138, 138, 0, 0, 0, 0, 0, 0, 0, 0, 0, 0, 0, 0, 0, 0, 138, 138, 138, 138, 138, 138, 138, 138, 138, 138, 138, 138
138, 138, 138, 138, 138, 138, 138, 138, 138, 138, 138, 138, 138, 138, 138, 0, 0, 0, 0, 0, 0, 0, 0, 0, 0, 0, 0, 138, 138, 138, 138, 138, 138, 138, 138, 138, 138, 138, 138, 138
138, 138, 138, 138, 138, 138, 138, 138, 138, 138, 138, 138, 138, 138, 138, 138, 0, 0, 0, 0, 0, 0, 0, 0, 0, 0, 138, 138, 138, 138, 138, 138, 138, 138, 138, 138, 138, 138, 138, 138
138, 138, 138, 138, 138, 138, 138, 138, 138, 138, 138, 138, 138, 138, 138, 138, 138, 0, 0, 0, 0, 0, 0, 0, 0, 138, 138, 138, 138, 138, 138, 138, 138, 138, 138, 138, 138, 138, 138, 138
138, 138, 138, 138, 138, 138, 138, 138, 138, 138, 138, 138, 138, 138, 138, 138, 138, 0, 0, 0, 0, 0, 0, 0, 0, 138, 138, 138, 138, 138, 138, 138, 138, 138, 138, 138, 138, 138, 138, 138
138, 138, 138, 138, 138, 138, 138, 138, 138, 138, 138, 138, 138, 138, 138, 138, 138, 138, 0, 0, 0, 0, 0, 0, 138, 138, 138, 138, 138, 138, 138, 138, 138, 138, 138, 138, 138, 138, 138, 138
138, 138, 138, 138, 138, 138, 138, 138, 138, 138, 138, 138, 138, 138, 138, 138, 138, 138, 138, 138, 0, 0, 138, 138, 138, 138, 138, 138, 138, 138, 138, 138, 138, 138, 138, 138, 138, 138, 138, 138
138, 138, 138, 138, 138, 138, 138, 138, 138, 138, 138, 138, 138, 138, 138, 138, 138, 138, 138, 138, 0, 0, 138, 138, 138, 138, 138, 138, 138, 138, 138, 138, 138, 138, 138, 138, 138, 138, 138, 138
138, 138, 138, 138, 138, 138, 138, 138, 138, 138, 138, 138, 138, 138, 138, 138, 138, 138, 138, 138, 138, 138, 138, 138, 138, 138, 138, 138, 138, 138, 138, 138, 138, 138, 138, 138, 138, 138, 138, 138
138, 138, 138, 138, 138, 138, 138, 138, 138, 138, 138, 138, 138, 138, 138, 138, 138, 138, 138, 138, 138, 138, 138, 138, 138, 138, 138, 138, 138, 138, 138, 138, 138, 138, 138, 138, 138, 138, 138, 138
138, 138, 138, 138, 138, 138, 138, 138, 138, 138, 138, 138, 138, 138, 138, 138, 138, 138, 138, 138, 138, 138, 138, 138, 138, 138, 138, 138, 138, 138, 138, 138, 138, 138, 138, 138, 138, 138, 138, 138
138, 138, 138, 138, 138, 138, 138, 138, 138, 138, 138, 138, 138, 138, 138, 138, 138, 138, 138, 138, 138, 138, 138, 138, 138, 138, 138, 138, 138, 138, 138, 138, 138, 138, 138, 138, 138, 138, 138, 138
138, 138, 138, 138, 138, 138, 138, 138, 138, 138, 138, 138, 138, 138, 138, 138, 138, 138, 138, 138, 138, 138, 138, 138, 138, 138, 138, 138, 138, 138, 138, 138, 138, 138, 138, 138, 138, 138, 138, 138
138, 138, 138, 138, 138, 138, 138, 138, 138, 138, 138, 138, 138, 138, 138, 138, 138, 138, 138, 138, 138, 138, 138, 138, 138, 138, 138, 138, 138, 138, 138, 138, 138, 138, 138, 138, 138, 138, 138, 138
138, 138, 138, 138, 138, 138, 138, 138, 138, 138, 138, 138, 138, 138, 138, 138, 138, 138, 138, 138, 138, 138, 138, 138, 138, 138, 138, 138, 138, 138, 138, 138, 138, 138, 138, 138, 138, 138, 138, 138
138, 138, 138, 138, 138, 138, 138, 138, 138, 138, 138, 138, 138, 138, 138, 138, 138, 138, 138, 138, 138, 138, 138, 138, 138, 138, 138, 138, 138, 138, 138, 138, 138, 138, 138, 138, 138, 138, 138, 138
138, 138, 138, 138, 138, 138, 138, 138, 138, 138, 138, 138, 138, 138, 138, 138, 138, 138, 138, 138, 138, 138, 138, 138, 138, 138, 138, 138, 138, 138, 138, 138, 138, 138, 138, 138, 138, 138, 138, 138
138, 138, 138, 138, 138, 138, 138, 138, 138, 138, 138, 138, 138, 138, 138, 138, 138, 138, 138, 138, 138, 138, 138, 138, 138, 138, 138, 138, 138, 138, 138, 138, 138, 138, 138, 138, 138, 138, 138, 138
138, 138, 138, 138, 138, 138, 138, 138, 138, 138, 138, 138, 138, 138, 138, 138, 138, 138, 138, 138, 138, 138, 138, 138, 138, 138, 138, 138, 138, 138, 138, 138, 138, 138, 138, 138, 138, 138, 138, 138
138, 138, 138, 138, 138, 138, 138, 138, 138, 138, 138, 138, 138, 138, 138, 138, 138, 138, 138, 138, 138, 138, 138, 138, 138, 138, 138, 138, 138, 138, 138, 138, 138, 138, 138, 138, 138, 138, 138, 138
138, 138, 138, 138, 138, 138, 138, 138, 138, 138, 138, 138, 138, 138, 138, 138, 138, 138, 138, 138, 138, 138, 138, 138, 138, 138, 138, 138, 138, 138, 138, 138, 138, 138, 138, 138, 138, 138, 138, 138
